Table 1
word	Final_rating																	
Markstein	bad																	
Volumen	bad																	
Flecken	mid																	
Profil	bad																	
Süßware	bad																	
Küstenlinie	bad																	
Sonnenmilch	bad																	
Geißel	bad																	
Bachstraße	bad																	
Grenadier	bad																	
Ziegelhausen	bad																	
Bootshaus	bad																	
Topas	bad																	
Sandwich	bad																	
Vorraum	mid																	
Spinnentier	bad																	
Sonnenstich	bad																	
Dreieck	bad																	
Pappel	good																	
Fangzahn	bad																	
Hochhaus	bad																	
Lyoner	bad																	
Atoll	bad																	
Hausboot	bad																	
Kirchhof	bad																	
Verdickung	bad																	
Siedlerin	bad																	
Anatom	bad																	
Rinne	mid																	
Lidschatten	bad																	
Haubitze	bad																	
Lämmchen	bad																	
Viertel	bad																	
Koloß	bad																	
Scheidewand	bad																	
Schindel	bad																	
Phalanx	bad																	
Fresko	bad																	
Weißdorn	bad																	
Schlupfloch	bad																	
Nasenbluten	bad																	
Blondschopf	bad																	
Eintopf	bad																	
Buschland	bad																	
Trockenmauer	bad																	
Dahlie	bad																	
Dicke	bad																	
Klecks	bad																	
Gaze	bad																	
Säckel	bad																	
Patina	bad																	
Schweinswal	bad																	
Swastika	bad																	
Harz	bad																	
Parzelle	bad																	
Superman	bad																	
Hohlraum	bad																	
Loch	good																	
Seitenschiff	bad																	
Borte	bad																	
Salz	bad																	
Sandelholz	bad																	
Schaubild	bad																	
Vorzimmer	mid																	
Sonnenbad	bad																	
Südstadt	bad																	
Moschus	bad																	
H&M	bad																	
Hexenschuß	bad																	
Nachbild	bad																	
Altarbild	bad																	
Münzstätte	bad																	
Gärtchen	bad																	
Lotus	bad																	
Wildblume	bad																	
Regiment	bad																	
Stammheimer	bad																	
Inhaltsstoff	bad																	
Tragwerk	bad																	
Buschwerk	bad																	
Fernglas	bad																	
Gartenstraße	bad																	
Lämpchen	bad																	
Faßbinder	bad																	
Albumin	bad																	
Eis	bad																	
Sandhügel	bad																	
Stute	bad																	
Sümmchen	bad																	
Säulengang	bad																	
Wagenlenker	bad																	
Schalentier	bad																	
Nektarine	bad																	
Wasserlinie	bad																	
Röschen	bad																	
Palisade	bad																	
Starterin	bad																	
Oberseite	bad																	
Bier	bad																	
Fahrkarte	bad																	
Nebenfluß	bad																	
Pilger	bad																	
Eiermann	bad																	
Asiatin	bad																	
Square	bad																	
Mauerwerk	bad																	
Fruchtzucker	bad																	
Reliquie	bad																	
Krabbe	bad																	
Languste	bad																	
Mikroskop	bad																	
Satin	bad																	
Paddock	bad																	
Achteck	bad																	
Kleinode	bad																	
Garbe	bad																	
Fernrohr	bad																	
Asbest	bad																	
Schneefeld	bad																	
Farmhaus	bad																	
Granat	bad																	
Whiskey	bad																	
Lippenstift	bad																	
Breme	bad																	
Fußgängerweg	bad																	
Fadenwurm	bad																	
Giftstoff	bad																	
Kardamom	bad																	
Stadtviertel	bad																	
Sphinx	bad																	
Fries	bad																	
Goldfinger	bad																	
Heer	bad																	
Retorte	bad																	
Fragment	bad																	
Fleckchen	bad																	
Pentagon	bad																	
Protein	bad																	
Kiwi	bad																	
Heimchen	bad																	
Leberfleck	bad																	
Plattfisch	bad																	
Kolbenhirse	bad																	
Kügelchen	bad																	
Kreuzotter	bad																	
Aster	bad																	
Hafenstraße	bad																	
Königsplatz	bad																	
Quartier	bad																	
Soutane	bad																	
Jerusalemer	bad																	
Mango	bad																	
Anwesen	bad																	
Jeans	bad																	
Nordhaus	bad																	
Steilküste	bad																	
Relief	bad																	
Laubengang	bad																	
Badehaus	bad																	
Paraffin	bad																	
Regenrinne	good																	
Lehm	mid																	
Membrane	bad																	
Olive	bad																	
Curry	bad																	
Schnauzbart	mid																	
Harnblase	bad																	
Planetarium	bad																	
Orange	bad																	
Atom	mid																	
Trüffel	bad																	
Haar	mid																	
Floß	bad																	
Kies	mid																	
Villa	good																	
Trikot	bad																	
Router	good																	
Luftröhre	bad																	
Zapfen	mid																	
Anorak	bad																	
Honigtau	bad																	
Mauer	good																	
Linse	bad																	
Rückleuchte	good																	
Saum	good																	
Gebirge	good																	
Porree	bad																	
Fell	bad																	
Heidelbeere	bad																	
Nasenflügel	bad																	
Aquarium	bad																	
Rachen	mid																	
Sirup	bad																	
Weintraube	bad																	
Uterus	bad																	
Stachelbeere	bad																	
Schirm	bad																	
Schuppe	good																	
Soda	bad																	
Pinie	good																	
Knospe	good																	
Bauchfell	mid																	
Felsbrocken	good																	
Nektar	bad																	
Lunge	bad																	
Faß	bad																	
Zahnfleisch	bad																	
Schopf	bad																	
Hirnstamm	mid																	
Grünkohl	bad																	
Kranz	bad																	
Talg	good																	
Felsgestein	good																	
Pulsader	bad																	
Palast	good																	
Schwefel	mid																	
Robe	bad																	
Kapsel	bad																	
Efeu	good																	
Gehöft	good																	
Halbmond	bad																	
Hausberg	bad																	
Lid	bad																	
Ikone	bad																	
Fjord	good																	
Tiara	bad																	
Pfefferminz	bad																	
Labyrinth	mid																	
Tatze	good																	
Hermelin	mid																	
Haus	good																	
Turmspitze	good																	
Lagune	mid																	
Tintenfaß	bad																	
Felsblock	good																	
Hirschgeweih	bad																	
Theke	bad																	
Schutzhütte	good																	
Sauce	bad																	
Moor	good																	
Lorbeer	bad																	
Pfefferminze	bad																	
Scheinwerfer	good																	
Kaulquappe	good																	
Schimmelpilz	good																	
Sarkophag	good																	
Stadtplan	bad																	
Kadaver	bad																	
Lavendel	bad																	
Süßspeise	bad																	
Knolle	good																	
Knoblauch	bad																	
Wodka	bad																	
Kot	bad																	
Nessel	mid																	
Erdkugel	good																	
Barke	bad																	
Buckel	bad																	
Sand	mid																	
Thymian	mid																	
Schleier	mid																	
Wanze	good																	
Alge	good																	
Licht	mid																	
Schädel	bad																	
Schlagader	bad																	
Asphalt	good																	
Ziegel	good																	
Hagelkorn	good																	
Kittel	bad																	
Raupe	good																	
Eichel	good																	
Niere	mid																	
Kolosseum	good																	
Eiter	bad																	
Gebüsch	good																	
Schlange	mid																	
Kiesel	good																	
Dunst	good																	
Trog	bad																	
Gruft	good																	
Parfum	bad																	
Laich	mid																	
Box	bad																	
Strand	mid																	
Fenster	bad																	
Bibliothek	good																	
Minze	mid																	
Hotel	bad																	
Hofgarten	bad																	
Werkhalle	bad																	
Raumfahrzeug	bad																	
Feuerball	bad																	
Jungtier	bad																	
Cafeteria	bad																	
Wein	bad																	
Weinrebe	bad																	
Radrennbahn	bad																	
Glyzerin	bad																	
Kloake	bad																	
Grüne	bad																	
Pool	bad																	
Brauhaus	bad																	
Augenoptiker	bad																	
Petroleum	bad																	
Schafgarbe	bad																	
Möhre	bad																	
Häuserblock	bad																	
Trankopfer	bad																	
Bauch	bad																	
Warze	bad																	
Agave	bad																	
Sombrero	bad																	
Sonnentau	bad																	
Treppenhaus	bad																	
Schiffswrack	bad																	
Eierlikör	bad																	
Büste	mid																	
Drehgestell	bad																	
Wildbret	bad																	
Matterhorn	bad																	
Graben	mid																	
Buchweizen	bad																	
Akazie	bad																	
Goldene	bad																	
Brustwarze	bad																	
Hafen	bad																	
Medaillon	bad																	
Rouge	bad																	
Gabelung	bad																	
Horoskop	bad																	
Rollbahn	bad																	
Halm	good																	
Imbiß	bad																	
Asche	good																	
Beton	good																	
Limonade	bad																	
Gewächshaus	bad																	
Bazar	bad																	
Siegel	bad																	
Bungalow	bad																	
Auster	bad																	
Wasserlassen	bad																	
Vesuv	bad																	
Vinaigrette	bad																	
Spalt	good																	
Hornhaut	bad																	
Basilikum	bad																	
Schellfisch	bad																	
Stirnlampe	bad																	
Küchlein	bad																	
Schilf	good																	
Armenviertel	bad																	
Heroin	bad																	
Beiwagen	bad																	
Aufdruck	bad																	
Casino	bad																	
Karawane	bad																	
Löwenzahn	bad																	
Rezeptur	bad																	
Mehlschwitze	bad																	
Nacken	bad																	
Sumpf	good																	
Träne	bad																	
Phosphor	bad																	
Flüssigkeit	bad																	
Baumkrone	bad																	
Reihenhaus	bad																	
Ufer	good																	
Hügelgrab	bad																	
Erdhügel	bad																	
Klümpchen	bad																	
Tibeter	bad																	
Miesmuschel	bad																	
Fistel	bad																	
Haube	mid																	
Gefechtskopf	bad																	
Rinde	mid																	
Süßstoff	bad																	
Faserstoff	bad																	
Prärie	bad																	
Pilz	bad																	
Himmel	mid																	
Hafer	bad																	
Haarer	bad																	
Faultier	bad																	
Elektron	bad																	
Eckzahn	bad																	
Kehle	bad																	
Friedhof	mid																	
Speiseröhre	bad																	
Mikrofilm	bad																	
Frontscheibe	bad																	
Ziegelstein	bad																	
S&P	bad																	
Innenhof	bad																	
Strauch	good																	
Hirse	bad																	
Bernstein	bad																	
Kessel	bad																	
Stausee	bad																	
Palais	bad																	
Mokka	bad																	
Alaun	bad																	
Bachlauf	bad																	
Straßenzug	bad																	
Biotop	bad																	
Tragfläche	bad																	
Antlitz	bad																	
Ludwigstraße	bad																	
Fenchel	bad																	
Kasino	bad																	
Schemen	bad																	
Spaghetti	bad																	
Lungenflügel	bad																	
Restaurant	bad																	
Festung	bad																	
Bahndamm	bad																	
Wassergraben	bad																	
Kellerkind	bad																	
Blütenstand	bad																	
Hemmstoff	bad																	
Grüngürtel	bad																	
Leopard	bad																	
Acre	bad																	
Fleck	good																	
Saft	bad																	
Fliege	bad																	
Torhaus	bad																	
Zifferblatt	bad																	
Kopftuch	bad																	
Planet	good																	
Kieme	good																	
Zitrone	bad																	
Champignon	bad																	
Omelett	bad																	
Aorta	bad																	
Dateiname	bad																	
Mastdarm	bad																	
Eingeweide	bad																	
Hohlweg	bad																	
Mammutbaum	bad																	
Vorhaut	bad																	
Quarter	bad																	
Sojabohne	bad																	
Äderchen	bad																	
Holzhaus	bad																	
Insekt	mid																	
Diagramm	mid																	
Spital	bad																	
Strichcode	bad																	
Jägerstraße	bad																	
Vietnamesin	bad																	
Espe	bad																	
Toga	bad																	
Schal	bad																	
Lätzchen	bad																	
Ovarium	bad																	
Oberhaut	bad																	
Blaue	bad																	
Fassade	good																	
Unze	bad																	
Kruste	bad																	
Sumpfland	bad																	
Gramm	bad																	
Florfliege	bad																	
Turban	bad																	
Kerzenlicht	bad																	
Rindfleisch	bad																	
Höcker	bad																	
Papyrus	bad																	
Monogramm	bad																	
Bullauge	bad																	
Viech	bad																	
Toast	bad																	
Milchzucker	bad																	
Gin	bad																	
Koralle	good																	
Steinweg	bad																	
Herberge	bad																	
Mähne	bad																	
Standarte	bad																	
Krem	bad																	
Tropf	bad																	
Drüse	bad																	
Maisfeld	bad																	
Infarkt	bad																	
Gourmet	bad																	
Brei	bad																	
Franse	bad																	
Magnesium	bad																	
Vorspeise	bad																	
Marzipan	bad																	
Treppe	bad																	
Frontseite	bad																	
Waschhaus	bad																	
Brust	bad																	
Namenszug	bad																	
Habit	bad																	
Stulle	bad																	
Kartell	bad																	
Dampfschiff	bad																	
Kaviar	bad																	
Kliff	bad																	
Areal	bad																	
Nußschale	bad																	
Schnellbahn	bad																	
Nachthemd	bad																	
Blutegel	bad																	
Rosenstock	bad																	
Salamander	bad																	
Triptychon	bad																	
Sockel	good																	
Baumbestand	bad																	
Landzunge	bad																	
Harnleiter	bad																	
Mikroalge	bad																	
Harnröhre	bad																	
Gipfel	good																	
Blei	bad																	
Gelände	good																	
Mütze	bad																	
Schattenbild	bad																	
Wandale	bad																	
Wallstraße	bad																	
Kornfeld	bad																	
Seehecht	bad																	
Börsenblatt	bad																	
Pudel	bad																	
Hibiskus	bad																	
Schlot	bad																	
Schlangenbiß	bad																	
Bidet	bad																	
Bronchitis	bad																	
Champagner	bad																	
Leuchtfeuer	bad																	
Ammonit	bad																	
Skelett	bad																	
Sardelle	bad																	
Arterie	bad																	
Wohnstatt	bad																	
Schnauze	bad																	
Rechteck	bad																	
Mutterleib	bad																	
Spalier	bad																	
Grabplatte	bad																	
Fischsuppe	bad																	
Zyankali	bad																	
Vorstadt	bad																	
Rauhfaser	bad																	
Wasserdampf	bad																	
Grasland	bad																	
Libelle	mid																	
Zyste	bad																	
Egge	bad																	
Gote	bad																	
Erdboden	bad																	
Milch	bad																	
Promenade	sound																	
Frucht	bad																	
Piste	mid																	
Symptom	bad																	
Fliegenpilz	mid																	
Fachwerk	bad																	
Tintenfisch	bad																	
Iglu	mid																	
Lotos	bad																	
Stadthaus	bad																	
Container	mid																	
Polyp	bad																	
Duplikat	bad																	
Fels	good																	
Hautarzt	bad																	
Bakterie	mid																	
Aquädukt	good																	
Guckloch	bad																	
Querschiff	bad																	
Lammfleisch	bad																	
Apfelwein	bad																	
Bakterium	mid																	
Saat	bad																	
Drehkreuz	bad																	
Makrele	mid																	
Mensa	bad																	
Gefach	bad																	
Betrachter	bad																	
Gerbstoff	bad																	
Bioreaktor	bad																	
Zement	bad																	
Yachthafen	bad																	
Anemone	bad																	
Knotenpunkt	bad																	
Kreuz	good																	
Stiege	bad																	
Ast	good																	
Würmchen	bad																	
Borax	bad																	
Pfeiler	good																	
Deck	bad																	
Speckstein	bad																	
Zypresse	bad																	
Korridor	bad																	
Ringelblume	bad																	
Vorschiff	bad																	
Hinterleib	bad																	
Heftchen	bad																	
Bitumen	bad																	
Creme	bad																	
Melone	bad																	
Raumfahrer	bad																	
Ranch	bad																	
Neon	bad																	
Mikrogramm	bad																	
Tentakel	bad																	
Stoßfänger	bad																	
Kapuze	bad																	
Antimon	bad																	
Meer	bad																	
Schlafmütze	bad																	
Facelift	bad																	
Sextant	bad																	
Wimpel	good																	
Randstein	bad																	
Holunder	mid																	
Amber	bad																	
Duft	mid																	
Bergwerk	bad																	
Schlund	good																	
Lava	good																	
Cabrio	bad																	
Trottoir	bad																	
Birne	bad																	
Weinberg	bad																	
Birkenstock	bad																	
Beuteltier	bad																	
Retina	bad																	
Kubus	bad																	
Kornblume	bad																	
Lilie	good																	
Stickstoff	bad																	
Pflanze	bad																	
Faksimile	bad																	
Kentaur	bad																	
Seevogel	bad																	
Gitter	good																	
Sturmtruppe	bad																	
Ginster	bad																	
Sund	bad																	
Wandschrank	bad																	
Morast	bad																	
Honig	bad																	
Mohrrübe	bad																	
Manna	bad																	
Reflektor	bad																	
Krone	bad																	
Anis	bad																	
Kiosk	bad																	
Quader	bad																	
Schilfrohr	bad																	
Weide	good																	
Tankschiff	bad																	
Frostbeule	bad																	
Semmel	bad																	
Irrgarten	bad																	
Beule	good																	
Ladenlokal	bad																	
Europaplatz	bad																	
Oblate	bad																	
Pavillon	good																	
Blazer	bad																	
Mangrove	bad																	
Thorax	bad																	
Vordach	bad																	
Kalk	bad																	
Bauwerk	bad																	
Kocher	bad																	
Kord	bad																	
Apotheke	bad																	
Liter	bad																	
Sparre	bad																	
Zeder	bad																	
Dickicht	bad																	
Biosensor	bad																	
Zentaur	bad																	
Absorber	bad																	
Leitungsbahn	bad																	
Nicolette	bad																	
Regenwasser	bad																	
Knäckebrot	bad																	
Schildkröte	bad																	
Ftp	bad																	
Fahrgestell	bad																	
Blütenpollen	bad																	
Herzkammer	bad																	
Marschland	bad																	
Statue	good																	
Mond	good																	
Kitt	bad																	
Steckrübe	bad																	
Handelsmarke	bad																	
Schleppnetz	bad																	
Ulan	bad																	
Rost	good																	
Schnurrbart	bad																	
Regentropfen	bad																	
Essig	bad																	
Essener	bad																	
Urin	bad																	
Halde	bad																	
Birke	good																	
Äuglein	bad																	
Pulpa	bad																	
Kopfende	bad																	
Farmland	bad																	
Querkopf	bad																	
Zwerg	bad																	
Tinktur	bad																	
Sonnencreme	bad																	
Embryo	bad																	
Pfirsich	bad																	
Chrysantheme	bad																	
Bikini	bad																	
Marienkäfer	bad																	
Hoden	bad																	
Limousine	bad																	
Speisesalz	bad																	
Bracke	bad																	
Pfahl	good																	
Gerinnsel	bad																	
Ballon	bad																	
Eisenhut	bad																	
Tröpfchen	bad																	
Gürtelrose	bad																	
Klitoris	bad																	
Kleinhirn	bad																	
Felsspalte	bad																	
Brösel	bad																	
Weichtier	bad																	
Sofa	bad																	
Gletscher	good																	
Berg	good																	
Streifen	mid																	
Stockwerk	bad																	
Kiefer	bad																	
Hügel	mid																	
Flußpferd	bad																	
Hockenheim	bad																	
Depot	bad																	
Leuchtdiode	bad																	
Landseite	bad																	
Barte	bad																	
Mauerstein	bad																	
Banknote	bad																	
Indio	bad																	
Schlamm	mid																	
Goetheplatz	bad																	
Prisma	bad																	
Narbe	mid																	
Blaubeere	bad																	
Mietskaserne	bad																	
Steinpilz	bad																	
Buchläden	bad																	
Riß	bad																	
Zimmer	good																	
Dotter	bad																	
Sternbild	bad																	
Gegengipfel	bad																	
Nebengebäude	bad																	
Erbse	bad																	
Autostadt	bad																	
Ringstraße	bad																	
Törtchen	bad																	
Stern	mid																	
Sindelfinger	bad																	
Wunderkerze	bad																	
Kakao	bad																	
Kassenbon	bad																	
Kragen	bad																	
Karamel	bad																	
Fleischhauer	bad																	
Unterleib	bad																	
Wanne	bad																	
Nelke	bad																	
Schneeregen	bad																	
Mauerstraße	bad																	
Vlies	bad																	
Staude	good																	
Feststoff	bad																	
Apartment	bad																	
Reklametafel	bad																	
Refraktor	bad																	
Pfeffer	bad																	
Wannenbad	bad																	
Kamm	bad																	
Haut	bad																	
Mosaik	bad																	
Eselsohr	bad																	
Fluß	bad																	
Meßbuch	bad																	
Sepia	bad																	
Kreide	bad																	
Myrrhe	bad																	
Stützpunkt	bad																	
Hundehütte	bad																	
Spitze	mid																	
Dachfenster	bad																	
Reservoir	bad																	
Bildzeichen	bad																	
Schlehe	bad																	
Raute	bad																	
Coupon	bad																	
Sekret	bad																	
Zusammenfluß	bad																	
Kieselstein	bad																	
Heckklappe	bad																	
Dock	bad																	
Eiskappe	bad																	
Tagebuch	bad																	
Nikotin	bad																	
Baum	bad																	
Kapillare	bad																	
Walroß	bad																	
Bohnenkraut	bad																	
Lutscher	bad																	
Paß	bad																	
Abhang	bad																	
Sonnenbrand	bad																	
Hörnchen	bad																	
Ambrosia	bad																	
Rotauge	bad																	
Brombeere	bad																	
Tarsus	bad																	
Glanzpunkt	bad																	
Teer	good																	
Schleim	good																	
Blase	bad																	
Sommerkleid	bad																	
Wandbild	bad																	
Mundwasser	bad																	
Zipfel	bad																	
Vestibül	bad																	
Unkraut	bad																	
Spektrometer	bad																	
Zugbrücke	bad																	
Schatzkammer	bad																	
Visier	bad																	
Format	bad																	
Latrine	bad																	
Lake	bad																	
Mahnmal	good																	
Veranda	mid																	
Götzenbild	bad																	
Bahnsteig	bad																	
Edelstein	bad																	
Sonnendach	bad																	
Rotunde	bad																	
Burgstraße	bad																	
Käfer	bad																	
Dachrinne	good																	
Steinbutt	mid																	
Uferstreifen	bad																	
Glimmer	bad																	
Joker	bad																	
Limo	bad																	
Seezunge	bad																	
Tempel	mid																	
Tumor	bad																	
Wandelhalle	bad																	
Kastanie	bad																	
Pünktchen	bad																	
Flagge	mid																	
Neugeborene	bad																	
Beinkleid	bad																	
Marienstraße	bad																	
Karlsplatz	bad																	
Erde	bad																	
Pfarrhof	bad																	
Wölkchen	bad																	
Augenbraue	bad																	
Feldstein	bad																	
Bruchstück	bad																	
Einfriedung	bad																	
Wasserfarbe	bad																	
Platz	mid																	
Spermium	bad																	
Patientin	bad																	
Husar	bad																	
Torbogen	bad																	
Bestäubung	bad																	
Azalee	bad																	
Galle	bad																	
Taverne	bad																	
Wasserlauf	bad																	
Wiederkäuer	bad																	
Bärtige	bad																	
Ecke	bad																	
Dachgeschoß	bad																	
Radstand	bad																	
Bridge	bad																	
Ulme	bad																	
Sakristei	bad																	
Schlafgemach	bad																	
Quecksilber	bad																	
Maggi	bad																	
Küchenzeile	bad																	
Sauerampfer	bad																	
Diamant	bad																	
Fühler	bad																	
Rezept	bad																	
Schriftzug	bad																	
Bläschen	bad																	
Kavallerie	bad																	
Bluter	bad																	
Quetzal	bad																	
Signet	bad																	
Blinker	bad																	
Totenkopf	bad																	
Unterkleid	bad																	
Wasserkopf	bad																	
Onyx	bad																	
Flügel	bad																	
Sonnenhut	bad																	
Treibhaus	bad																	
Bazillus	bad																	
Meile	bad																	
Sandstein	mid																	
Siedlung	mid																	
Schlüpfer	bad																	
Nimbus	bad																	
Röte	bad																	
Kalzium	bad																	
Gaumen	bad																	
Soße	bad																	
Waisenhaus	bad																	
Zähnchen	bad																	
Whisky	bad																	
Stachel	good																	
Atrium	bad																	
Trakt	bad																	
Pulver	mid																	
Britin	bad																	
Banane	bad																	
Pigment	bad																	
Schandfleck	bad																	
Treppchen	bad																	
Schlafsaal	bad																	
Behaarung	bad																	
Pissoir	bad																	
Drogist	bad																	
Glashaus	bad																	
Diele	good																	
Sternenstaub	bad																	
Obelisk	bad																	
Grünspan	bad																	
Täfelchen	bad																	
Bauernhaus	bad																	
Luftblase	bad																	
Wassermelone	bad																	
Seehafen	bad																	
Seestern	good																	
Dickdarm	bad																	
Seebrücke	bad																	
Barett	bad																	
Cocktail	bad																	
Likör	bad																	
Nautilus	bad																	
Meersalz	bad																	
Dach	good																	
Königstraße	bad																	
Zecke	bad																	
Türpfosten	bad																	
Totenschädel	bad																	
Tran	bad																	
Stirn	bad																	
Hahnenfuß	bad																	
Mineralstoff	bad																	
Silhouette	bad																	
Pore	bad																	
Staub	mid																	
Barrel	bad																	
Vulva	bad																	
Pocke	bad																	
Backbone	bad																	
Katakombe	bad																	
Oststadt	bad																	
Abbild	bad																	
Steinbock	bad																	
Botulismus	bad																	
Fackel	bad																	
Nest	mid																	
Paella	bad																	
Sediment	bad																	
Nilpferd	bad																	
Dunkelkammer	bad																	
Falkensee	bad																	
Rosette	bad																	
Schienenbahn	bad																	
Zimt	bad																	
Kichererbse	bad																	
Spurweite	bad																	
Winterhude	bad																	
Stadtrand	bad																	
Huftier	bad																	
Vorhof	mid																	
Krematorium	bad																	
Viereck	bad																	
Raster	bad																	
Binde	bad																	
Beere	bad																	
Tunnel	bad																	
Schwertfisch	bad																	
Inkubator	bad																	
Lupine	bad																	
Kirsche	bad																	
Zapfstelle	bad																	
Körpergröße	bad																	
Kotflügel	bad																	
Mikrobiologe	bad																	
Bildpunkt	bad																	
Gras	bad																	
Blinddarm	bad																	
Bruchbude	bad																	
Zentrum	bad																	
Portrait	bad																	
Wolke	mid																	
Blütenblatt	bad																	
Altar	good																	
Pudding	bad																	
Schattenriß	bad																	
Umzäunung	bad																	
Auge	bad																	
Gebälk	bad																	
Souvenir	bad																	
Emblem	good																	
Meßfühler	bad																	
Muschel	bad																	
Seeufer	bad																	
Chrom	mid																	
Pyjama	bad																	
Armenhaus	bad																	
Margerite	bad																	
Griffel	bad																	
Kalbfleisch	bad																	
Süßwasser	bad																	
Fotograf	bad																	
Pflaume	bad																	
Mondkalb	bad																	
Checkpoint	bad																	
Porträt	good																	
Madonna	bad																	
Seepferdchen	bad																	
Garnele	bad																	
Rippchen	bad																	
Karat	bad																	
Weinstock	bad																	
Küste	bad																	
Alabaster	bad																	
Trabant	bad																	
Rennpferd	bad																	
Flurstück	bad																	
Spring	bad																	
Borke	good																	
Aprikose	bad																	
Baskenmütze	bad																	
Pfau	mid																	
Auguststraße	bad																	
Farbstoff	bad																	
Falter	mid																	
Tonerde	bad																	
Einhorn	bad																	
Flaneur	bad																	
Abzeichen	good																	
Zirrhose	bad																	
Gekreuzigte	bad																	
Fahrstreifen	bad																	
Zwischenstop	bad																	
Mahagoni	bad																	
Hämoglobin	bad																	
Grünzeug	bad																	
Südland	bad																	
Gesicht	bad																	
Trikolore	bad																	
Muttermal	bad																	
Kinn	bad																	
Speisekammer	bad																	
Ladenhüter	bad																	
Tempelhof	bad																	
Gästehaus	bad																	
Traube	bad																	
Spirituose	bad																	
Rispe	bad																	
Skorpion	bad																	
Köpfchen	bad																	
Terpentin	bad																	
Pollen	good																	
Molekül	mid																	
Perle	bad																	
Erdbeere	bad																	
Bohrturm	bad																	
Münsterplatz	bad																	
Dromedar	bad																	
Netzhaut	bad																	
Karree	bad																	
Keil	bad																	
Himmelszelt	bad																	
Nabel	bad																	
Süßholz	bad																	
Velodrom	bad																	
Nanogramm	bad																	
Umrandung	bad																	
Schwanz	bad																	
Buttermilch	bad																	
Nougat	bad																	
Bahnstraße	bad																	
Hummer	bad																	
Coupé	bad																	
Zedernholz	bad																	
Datensatz	bad																	
Körnchen	bad																	
Tropfen	bad																	
Patte	bad																	
Präparat	bad																	
Marone	mid																	
Quadrat	bad																	
Emulsion	bad																	
Etikett	bad																	
Pelikan	bad																	
Flunder	mid																	
Infanterie	bad																	
Glas	bad																	
Aceton	bad																	
Lende	bad																	
Stadtstaat	bad																	
Tomate	bad																	
Fettback	bad																	
Magen	bad																	
Buddha	bad																	
Halsband	bad																	
Yard	bad																	
Flor	bad																	
Siesta	bad																	
Gewürznelke	bad																	
Schrein	good																	
Pixel	bad																	
Rebe	mid																	
Oxid	bad																	
Speisekarte	bad																	
Mast	good																	
Viadukt	mid																	
Laubblatt	bad																	
Glatze	bad																	
Brille	bad																	
Sari	bad																	
Kofferraum	bad																	
Zuckerbrot	bad																	
Pier	bad																	
Rille	good																	
Hirninfarkt	bad																	
Hermannplatz	bad																	
Leitplanke	mid																	
Rind	bad																	
Mädchen	bad																	
Kamel	bad																	
Plutonium	bad																	
Flagschiff	bad																	
Blume	bad																	
Kalkstein	bad																	
Marmor	bad																	
Tank	bad																	
Gläschen	bad																	
Altarraum	bad																	
Omelette	bad																	
Vene	good																	
Kaninchen	bad																	
Wespe	bad																	
Karpfen	mid																	
Leber	bad																	
Marienplatz	bad																	
Joppe	bad																	
Vorbau	bad																	
Buchsbaum	bad																	
Slum	bad																	
Appartement	bad																	
Phallus	bad																	
Zyanid	bad																	
Panier	bad																	
Kaschemme	bad																	
Amulett	bad																	
Wehrgang	bad																	
Kleinod	bad																	
Pagode	bad																	
Arsen	bad																	
Blättchen	bad																	
Ratskeller	bad																	
Wandgemälde	bad																	
Jahnplatz	bad																	
Sonde	good																	
Erdapfel	bad																	
Spiegel	bad																	
Geschwür	bad																	
Rachenraum	bad																	
Mehlwurm	bad																	
Kaliber	bad																	
Kordon	bad																	
Vorderfront	bad																	
Schnee	bad																	
Säule	good																	
Kieselalge	bad																	
Augenlid	bad																	
Flügeldecke	bad																	
Kismet	bad																	
Cognac	bad																	
Brandmauer	bad																	
Wacholder	bad																	
Brillenglas	bad																	
Orchidee	bad																	
Kammer	good																	
Geburtshaus	bad																	
Zisterne	bad																	
Beiboot	bad																	
Gecko	good																	
Apfelsine	bad																	
Supermodel	bad																	
Vogelbeere	bad																	
Sandbank	good																	
Meeresfrucht	bad																	
Fohlen	bad																	
Zwiebel	bad																	
Helm	bad																	
Findling	bad																	
Straßenrand	bad																	
Meeresboden	bad																	
Aktenstück	bad																	
Rebstock	mid																	
Schwarze	bad																	
Barfüßer	bad																	
Plunder	bad																	
Sauerkraut	bad																	
Hämatom	mid																	
Zebra	bad																	
Glimmstengel	bad																	
Tulpe	good																	
Krug	bad																	
Suppe	bad																	
Blütenstaub	bad																	
Adreßbuch	bad																	
Zwerchfell	bad																	
Gefieder	mid																	
Zwinger	bad																	
Darm	mid																	
Limone	bad																	
Kajüte	bad																	
Grapefruit	bad																	
Filmmaterial	bad																	
Zwickel	bad																	
Schnecke	good																	
Mausoleum	bad																	
Gasse	mid																	
Granatapfel	bad																	
Mongole	bad																	
Judengasse	bad																	
Lamm	mid																	
Brennessel	bad																	
Wurmfortsatz	bad																	
Auswuchs	bad																	
Rinnstein	bad																	
Marstall	bad																	
Oleander	bad																	
Vereinshaus	bad																	
Aroma	bad																	
Thuja	bad																	
Krustentier	bad																	
Flanke	bad																	
Kohlehydrat	bad																	
Acker	mid																	
Zitadelle	good																	
Kodex	bad																	
Euter	bad																	
Karosse	bad																	
Quai	bad																	
Heilbutt	bad																	
Meeresgrund	mid																	
Ringbahn	bad																	
Eiweiß	bad																	
Flieder	good																	
Düne	good																	
Territorium	bad																	
Mantel	bad																	
Wasser	bad																	
Gestein	mid																	
Brustwehr	bad																	
Kleeblatt	bad																	
Sonnenschein	bad																	
Brückenkopf	bad																	
Hüttenwerk	bad																	
Wegweiser	bad																	
Gallenblase	bad																	
Kegel	bad																	
Nordstadt	bad																	
Sonnenbank	bad																	
Appartment	bad																	
Kirschwasser	bad																	
Anlegestelle	bad																	
Vorplatz	bad																	
Basar	bad																	
Zelle	mid																	
Hülsenfrucht	bad																	
Dachboden	bad																	
Weingärtner	bad																	
Frikadelle	bad																	
Kutte	bad																	
Plätzchen	bad																	
Schlafraum	bad																	
Grab	good																	
Bastion	bad																	
Hochstraße	bad																	
Polyeder	bad																	
Fußspur	bad																	
Gaswerk	bad																	
Kobra	bad																	
Gebärmutter	bad																	
Hieroglyphe	bad																	
Okular	bad																	
Mumie	good																	
Uniform	bad																	
Rumpf	bad																	
Talisman	bad																	
Kokain	bad																	
Sensor	good																	
Exkrement	bad																	
Fototermin	bad																	
Verdeck	good																	
Larve	bad																	
Feuerkugel	bad																	
Blüte	bad																	
Grabmal	good																	
Schneeball	bad																	
Samenkorn	bad																	
Sonnenblume	bad																	
Kavallerist	bad																	
Schweif	mid																	
Baldrian	bad																	
Stalaktit	bad																	
Kopeke	bad																	
Herd	bad																	
Kabeljau	bad																	
Dampfboot	bad																	
Kuppel	mid																	
Flocke	bad																	
Rote	bad																	
Qualm	bad																	
Schiebedach	bad																	
Gift	bad																	
Stamm	good																	
Bildnis	good																	
Lichthof	bad																	
Bindehaut	bad																	
Natter	good																	
Schalotte	mid																	
Teleskop	bad																	
Boot	bad																	
Garnison	bad																	
Schimmel	bad																	
Yoghurt	bad																	
Hühnerauge	bad																	
Schatzhaus	bad																	
Getränk	bad																	
Bodega	bad																	
Kristall	mid																	
Büschel	bad																	
Fontäne	mid																	
Busen	bad																	
Currywurst	bad																	
Galgen	bad																	
Heidekraut	bad																	
Kohlenhydrat	bad																	
Halstuch	bad																	
Foliant	bad																	
Zusatzstoff	bad																	
Krater	good																	
Zitronengras	bad																	
Verlies	good																	