Table 1
word	Final_rating																
Lippenstift	bad																
Buttermilch	bad																
Rippchen	bad																
Kodex	bad																
Garbe	bad																
Reklametafel	bad																
Hochhaus	bad																
Mokka	bad																
Bodega	bad																
Ziegelhausen	bad																
Patina	bad																
Arsen	bad																
Kliff	bad																
Rotauge	bad																
Thorax	bad																
Thuja	bad																
Beinkleid	bad																
Flor	bad																
Klümpchen	bad																
Sonnenstich	bad																
Katakombe	bad																
Frostbeule	bad																
Rechteck	bad																
Imbiß	bad																
Habit	bad																
Jahnplatz	bad																
Quadrat	bad																
Meile	bad																
Armenviertel	bad																
Jägerstraße	bad																
Schlund	mid																
Hemmstoff	bad																
Dampfschiff	bad																
Dateiname	bad																
Nicolette	bad																
Kentaur	bad																
Maisfeld	bad																
Farmland	bad																
Weingärtner	bad																
Protein	bad																
Königstraße	bad																
Quartier	mid																
Florfliege	bad																
Asiatin	bad																
Schweinswal	bad																
Pentagon	bad																
Quecksilber	bad																
Glimmstengel	bad																
Gaze	bad																
Magnesium	bad																
Meeresboden	bad																
Sepia	bad																
Kohlenhydrat	bad																
Wasserlassen	bad																
Bildzeichen	bad																
Lutscher	bad																
Eiweiß	bad																
Mahagoni	bad																
Spalier	bad																
Liter	bad																
Reihenhaus	bad																
Einfriedung	bad																
Kajüte	good																
Bitumen	bad																
Plunder	bad																
Fußspur	bad																
Moschus	bad																
Treibhaus	bad																
Vereinshaus	bad																
Bruchbude	bad																
Stirnlampe	bad																
Semmel	bad																
Fußgängerweg	bad																
Pagode	bad																
Hexenschuß	bad																
Vorraum	bad																
Franse	bad																
Breme	bad																
Bronchitis	bad																
Emulsion	bad																
Eselsohr	bad																
Dampfboot	bad																
Stiege	bad																
Zwickel	bad																
Biosensor	bad																
Sauerampfer	bad																
Polyeder	bad																
Zyanid	bad																
Schlafmütze	bad																
Mikrogramm	bad																
Essener	bad																
Hahnenfuß	bad																
Inhaltsstoff	bad																
Gabelung	bad																
Ulme	bad																
Geburtshaus	bad																
Stickstoff	bad																
Bestäubung	bad																
Rotunde	bad																
Kamm	bad																
Süßwasser	bad																
Blondschopf	bad																
Whiskey	bad																
Heer	bad																
Treppenhaus	bad																
Bruchstück	bad																
Barte	bad																
Wandale	bad																
Hafenstraße	bad																
Giftstoff	bad																
Mutterleib	bad																
Tran	bad																
Schaubild	bad																
Tibeter	bad																
Volumen	bad																
Galgen	bad																
Wallstraße	bad																
Adreßbuch	bad																
Tempelhof	bad																
Mehlschwitze	bad																
Innenhof	bad																
Trockenmauer	bad																
Retorte	bad																
Omelett	bad																
Paella	bad																
Rollbahn	bad																
Kleinode	bad																
Aufdruck	good																
Stausee	good																
Landseite	bad																
Oberseite	bad																
Anemone	bad																
Nasenbluten	bad																
Handelsmarke	bad																
Joker	bad																
Stadtviertel	bad																
Kaliber	bad																
Monogramm	bad																
Hermannplatz	bad																
Rinne	mid																
Blütenblatt	bad																
Ratskeller	bad																
Kolosseum	bad																
Möhre	mid																
Piste	mid																
Hügel	good																
Territorium	good																
Meeresgrund	good																
Pfefferminz	mid																
Strauch	good																
Beuteltier	good																
Bidet	bad																
Tatze	good																
Phosphor	good																
Huftier	bad																
Beton	good																
Veranda	good																
Süßware	bad																
Blaubeere	bad																
Currywurst	bad																
Fenchel	mid																
Trabant	bad																
Sockel	good																
Champagner	bad																
Flagge	good																
Hundehütte	bad																
Inkubator	bad																
Straßenzug	bad																
Container	mid																
Talisman	good																
Felsbrocken	good																
Fragment	good																
Pflanze	mid																
Wasserfarbe	bad																
Auge	bad																
Weinstock	good																
Stachel	good																
Flunder	good																
Pavillon	good																
Findling	bad																
Ringbahn	bad																
Erdbeere	bad																
Halm	good																
Getränk	bad																
Halstuch	bad																
Pinie	good																
Leber	bad																
Milch	bad																
Trikot	bad																
Kuppel	good																
Speisekarte	bad																
Bildnis	good																
Sonnenmilch	bad																
Borke	good																
Traube	bad																
Floß	mid																
Hornhaut	good																
Abhang	good																
Creme	bad																
Vorstadt	good																
Präparat	good																
Farbstoff	good																
Wespe	good																
Pfau	good																
Falter	good																
Bahnsteig	bad																
Tumor	bad																
Lehm	good																
Schirm	bad																
Rouge	bad																
Wacholder	good																
Gärtchen	bad																
Zement	good																
Erbse	mid																
Box	bad																
Zimmer	good																
Kiwi	bad																
Sand	good																
Visier	good																
Wandgemälde	bad																
Hafer	mid																
Rezept	bad																
Boot	bad																
Kalkstein	good																
Kamel	good																
Talg	good																
Erdapfel	mid																
Sonnencreme	bad																
Tunnel	good																
Olive	bad																
Kieme	good																
Laubblatt	good																
Zitronengras	bad																
Depot	good																
Fell	mid																
Treppchen	bad																
Blütenstaub	good																
Luftblase	good																
Lavendel	good																
Flecken	good																
Wolke	good																
Sonnentau	good																
Basar	bad																
Reliquie	good																
Anis	bad																
Uferstreifen	mid																
Zwerchfell	good																
Korridor	good																
Augenlid	bad																
Seehecht	bad																
Kruste	good																
Pfeiler	good																
Pocke	good																
Glas	bad																
Lätzchen	mid																
Mumie	good																
Sandstein	good																
Grünkohl	bad																
Steinbutt	mid																
Pfirsich	bad																
Spektrometer	bad																
Gestein	good																
Schneeball	bad																
Bikini	bad																
Felsblock	good																
Brust	bad																
Licht	mid																
Marmor	good																
Felsspalte	good																
Aorta	bad																
Elektron	mid																
Pore	good																
Gebüsch	good																
Herberge	bad																
Tintenfisch	bad																
Leberfleck	good																
Granatapfel	bad																
Halbmond	bad																
Limone	bad																
Lämmchen	bad																
Gesicht	bad																
Oblate	bad																
Essig	bad																
Flocke	good																
Tentakel	good																
Hülsenfrucht	bad																
Einhorn	good																
Asphalt	good																
Sandwich	bad																
Spermium	bad																
Ludwigstraße	bad																
Faßbinder	bad																
Drüse	bad																
Grünspan	bad																
Würmchen	bad																
Obelisk	bad																
Gehöft	good																
Äderchen	bad																
Münzstätte	bad																
Vulva	bad																
Südland	bad																
Sensor	good																
Gerinnsel	mid																
Heftchen	bad																
Teleskop	bad																
Nußschale	bad																
Schneeregen	bad																
Triptychon	bad																
Karat	bad																
Koralle	good																
Buddha	bad																
Duplikat	bad																
Hausberg	bad																
Nacken	bad																
Knäckebrot	bad																
Schlagader	bad																
Küstenlinie	bad																
Gebärmutter	bad																
Sphinx	good																
Steckrübe	bad																
Lotus	bad																
Kasino	bad																
Hirschgeweih	bad																
Aceton	bad																
Buchweizen	bad																
Verlies	good																
Satin	bad																
Flurstück	bad																
Kopeke	bad																
Siedlung	bad																
Leitungsbahn	bad																
Ballon	bad																
Hermelin	bad																
Tarsus	bad																
Euter	bad																
Gläschen	bad																
Kord	bad																
Infanterie	bad																
Datensatz	bad																
Husar	bad																
Rosenstock	bad																
Unterleib	bad																
Gaumen	bad																
S&P	bad																
Stadthaus	bad																
Süßstoff	bad																
Fotograf	bad																
Ladenhüter	bad																
Verdeck	bad																
Restaurant	bad																
Pissoir	bad																
Röte	bad																
Blinker	bad																
Klecks	good																
Anlegestelle	bad																
Flügel	bad																
Nordhaus	bad																
Tempel	good																
Fangzahn	bad																
Milchzucker	bad																
Pfarrhof	bad																
Kirsche	bad																
Seezunge	bad																
Seestern	bad																
Pyjama	bad																
Kalbfleisch	bad																
Weinrebe	bad																
Gebälk	bad																
Rosette	bad																
Alge	good																
Bioreaktor	bad																
Ziegel	bad																
Gletscher	good																
Ringelblume	bad																
Spurweite	bad																
Skorpion	bad																
Zentrum	bad																
Baum	bad																
Schatzhaus	bad																
Burgstraße	bad																
Spalt	good																
Foliant	bad																
Blazer	bad																
Myrrhe	bad																
Mikroskop	bad																
Bauernhaus	bad																
Kammer	good																
Ammonit	bad																
Frucht	bad																
Sund	bad																
Bindehaut	bad																
Trakt	mid																
Rauhfaser	bad																
Kot	bad																
Rinde	good																
Irrgarten	bad																
Lidschatten	bad																
Blaue	bad																
Suppe	bad																
Emblem	good																
Himmelszelt	bad																
Orange	bad																
Schandfleck	bad																
Krone	bad																
Friedhof	good																
Chrom	bad																
Meersalz	bad																
Holzhaus	bad																
Himmel	good																
Namenszug	bad																
Türpfosten	bad																
Ambrosia	bad																
Mikroalge	bad																
Slum	bad																
Gefieder	mid																
Baumbestand	bad																
Strichcode	bad																
Spring	bad																
Paddock	bad																
Kopfende	bad																
Buschland	bad																
Schleppnetz	bad																
Fliege	bad																
Oststadt	bad																
Blütenstand	bad																
Blume	bad																
Stoßfänger	bad																
Bohrturm	bad																
Wasserdampf	bad																
Kegel	bad																
Hagelkorn	bad																
Schlüpfer	bad																
Blütenpollen	bad																
Sternenstaub	bad																
Fistel	bad																
Fototermin	bad																
Dunkelkammer	bad																
Streifen	bad																
Radstand	bad																
Ziegelstein	bad																
Stamm	good																
Sumpf	good																
Stirn	bad																
Papyrus	bad																
Hockenheim	bad																
Kotflügel	bad																
Palais	bad																
Gourmet	bad																
Nebenfluß	bad																
Kloake	bad																
Grüne	bad																
Griffel	bad																
Karosse	bad																
Tropfen	bad																
Lupine	bad																
Tropf	bad																
Laubengang	bad																
Schrein	bad																
Hirse	bad																
Nilpferd	bad																
Tintenfaß	bad																
Thymian	bad																
Siegel	bad																
Retina	bad																
Antimon	bad																
Fenster	bad																
Zifferblatt	bad																
Fries	bad																
Alaun	bad																
Grab	good																
Kittel	bad																
Leitplanke	good																
Faultier	bad																
Coupé	bad																
Sojabohne	bad																
Bernstein	bad																
Casino	bad																
Wasserlauf	bad																
Mohrrübe	bad																
Autostadt	bad																
Dach	good																
Schleier	bad																
Mantel	bad																
Kapuze	bad																
Augenbraue	bad																
Waschhaus	bad																
Kordon	bad																
Blinddarm	bad																
Radrennbahn	bad																
Teer	good																
Bluter	bad																
Lämpchen	bad																
Schleim	mid 																
Stützpunkt	bad																
Toast	bad																
Kleeblatt	bad																
Mauerwerk	bad																
Bläschen	bad																
Nachbild	bad																
Wunderkerze	bad																
Trikolore	bad																
Baskenmütze	bad																
Muttermal	bad																
Kaviar	bad																
Schemen	bad																
Cafeteria	bad																
Haar	bad																
Blüte	bad																
Höcker	bad																
Frikadelle	bad																
Schattenriß	bad																
Darm	bad																
Spital	bad																
Neon	bad																
Linse	bad																
Cocktail	bad																
Grüngürtel	bad																
Fahrgestell	bad																
Hirnstamm	mid																
Glimmer	bad																
Raupe	mid																
Brombeere	bad																
Unze	bad																
Rumpf	bad																
Lammfleisch	bad																
Asche	good																
Zapfen	good																
Kapillare	bad																
Rezeptur	bad																
Fernglas	bad																
Raster	bad																
Absorber	bad																
Edelstein	bad																
Molekül	bad																
Regenwasser	bad																
Schiffswrack	bad																
Statue	good																
Vorhaut	bad																
Wassergraben	bad																
Wildbret	bad																
Checkpoint	bad																
Judengasse	bad																
Tiara	bad																
Dachgeschoß	bad																
Ovarium	bad																
Totenkopf	bad																
Soutane	bad																
Hoden	bad																
Sparre	bad																
Träne	bad																
Iglu	good																
Bastion	bad																
Tulpe	bad																
Rispe	bad																
Gift	bad																
Schwertfisch	bad																
Rebe	good																
Kaschemme	bad																
Mütze	bad																
Rückleuchte	mid																
Halsband	bad																
Jeans	bad																
Curry	bad																
Berg	bad																
Sextant	bad																
Wimpel	mid																
Kavallerist	bad																
Treppe	bad																
Dreieck	bad																
Küchenzeile	bad																
Siedlerin	sound																
Profil	bad																
Glashaus	bad																
Embryo	bad																
Loch	good																
Stern	mid																
Fadenwurm	mid																
Honig	bad																
Bakterium	good																
Trankopfer	bad																
Haarer	bad																
Mauer	good																
Acker	good																
Pünktchen	bad																
Speiseröhre	bad																
Barett	bad																
Gewürznelke	bad																
Lake	bad																
Oxid	bad																
Marzipan	bad																
Königsplatz	bad																
Fels	good																
Plutonium	bad																
Promenade	sound																
Gerbstoff	bad																
Mahnmal	bad																
Eiermann	bad																
Lichthof	bad																
Salamander	bad																
Riß	bad																
Luftröhre	bad																
Sommerkleid	bad																
Buckel	bad																
Sandbank	bad																
Muschel	bad																
Täfelchen	bad																
Wölkchen	mid																
Supermodel	sound																
Omelette	bad																
Torhaus	bad																
Gewächshaus	bad																
Mosaik	bad																
Uterus	bad																
Schnee	bad																
Paß	bad																
Marstall	bad																
Kismet	bad																
Kellerkind	sound																
Zwinger	bad																
Gefechtskopf	bad																
Südstadt	bad																
Sari	bad																
Erdhügel	good																
Hummer	bad																
Gartenstraße	bad																
Umrandung	bad																
Viech	bad																
Rachenraum	bad																
Beule	good																
Planetarium	bad																
Yoghurt	bad																
Mond	good																
Plätzchen	bad																
Kohlehydrat	bad																
Lava	bad																
Mikrobiologe	sound																
Hörnchen	bad																
Reservoir	bad																
Fackel	bad																
Heimchen	bad																
Baumkrone	bad																
Gebirge	good																
Madonna	bad																
Wannenbad	bad																
Nougat	bad																
Meßfühler	bad																
Languste	bad																
Gipfel	good																
Grabmal	good																
Magen	bad																
Neugeborene	bad																
Schlafraum	bad																
Sumpfland	good																
Zyankali	bad																
Planet	mid																
Pfefferminze	bad																
Faserstoff	bad																
Porträt	good																
Goldene	bad																
Gitter	mid																
Atoll	bad																
Kranz	bad																
Bakterie	bad																
Schnauzbart	bad																
Nautilus	bad																
Soda	bad																
Backbone	bad																
Krematorium	bad																
Staub	mid																
Starterin	bad																
Rindfleisch	bad																
Zimt	bad																
Blase	bad																
Pappel	good																
Eiter	bad																
Lamm	mid																
Schimmel	bad																
Haus	bad																
Beiboot	bad																
Pfahl	good																
Appartement	bad																
Viertel	bad																
Zipfel	good																
Zelle	bad																
Format	bad																
Barrel	bad																
Weichtier	bad																
Glyzerin	bad																
Nektarine	bad																
Schalentier	bad																
Nimbus	bad																
Mast	good																
Nanogramm	bad																
Schwefel	bad																
Okular	bad																
Schlafgemach	bad																
Behaarung	bad																
Yard	bad																
Porree	bad																
Baldrian	bad																
Süßspeise	bad																
Meßbuch	bad																
Prärie	good																
Kartell	bad																
Gegengipfel	bad																
Sandhügel	good																
Flieder	good																
Nessel	good																
Randstein	bad																
Börsenblatt	bad																
Quetzal	bad																
Helm	bad																
Vene	bad																
Pudel	bad																
Kolbenhirse	bad																
Reflektor	mid																
Schal	bad																
Schlot	bad																
Schafgarbe	bad																
Spitze	bad																
Wanze	bad																
Kofferraum	bad																
Speisesalz	bad																
Birke	good																
Bazillus	bad																
Zahnfleisch	bad																
Sediment	mid																
Morast	mid																
Ecke	bad																
Gürtelrose	bad																
Kutte	bad																
Eisenhut	bad																
Filmmaterial	bad																
Oberhaut	bad																
Zuckerbrot	bad																
Nabel	bad																
Lunge	bad																
Sonnenbad	bad																
Champignon	bad																
Salz	bad																
Skelett	bad																
Parzelle	bad																
Säule	mid																
Topas	bad																
Binde	bad																
Basilikum	bad																
Fahrkarte	bad																
Portrait	good																
Vorbau	bad																
Tragfläche	bad																
Schattenbild	bad																
Hochstraße	bad																
Schlamm	good																
Rind	bad																
Gasse	mid																
Laich	bad																
Frontscheibe	bad																
Netzhaut	bad																
Bazar	bad																
Kadaver	bad																
Heidekraut	bad																
Törtchen	bad																
Amulett	bad																
Limonade	bad																
Zecke	bad																
Parfum	bad																
Marone	bad																
Anorak	bad																
Dunst	mid																
Atrium	bad																
Birne	bad																
Meeresfrucht	bad																
Zähnchen	bad																
Swastika	bad																
Barfüßer	bad																
Stammheimer	bad																
Infarkt	bad																
Patientin	sound																
Flußpferd	bad																
Hieroglyphe	bad																
Lilie	bad																
Relief	bad																
Karpfen	bad																
Münsterplatz	bad																
Spiegel	bad																
Aquädukt	good																
Herd	bad																
Rost	bad																
Plattfisch	bad																
Raute	bad																
Erde	mid																
Bachstraße	bad																
Paraffin	bad																
Sardelle	bad																
Köpfchen	bad																
Ulan	bad																
Borax	bad																
Schienenbahn	bad																
Stachelbeere	bad																
Heidelbeere	bad																
Qualm	mid																
Felsgestein	bad																
Villa	bad																
Walroß	bad																
Kreuzotter	bad																
Erdboden	bad																
Stadtrand	bad																
Wegweiser	good																
Schellfisch	bad																
Deck	bad																
Leuchtdiode	bad																
Käfer	bad																
Fleckchen	bad																
Gefach	bad																
Vietnamesin	bad																
Blättchen	bad																
Kaulquappe	bad																
Eingeweide	bad																
Standarte	bad																
Trog	bad																
Nelke	mid																
Steinpilz	bad																
Phalanx	bad																
Hinterleib	bad																
Brustwarze	bad																
Schädel	bad																
Oleander	bad																
Manna	bad																
Augenoptiker	bad																
Werkhalle	bad																
Speisekammer	bad																
Röschen	bad																
Palisade	bad																
Hohlweg	bad																
Wehrgang	bad																
Lyoner	bad																
Blutegel	bad																
Sakristei	bad																
Kopftuch	bad																
Kügelchen	bad																
Sturmtruppe	bad																
Harnröhre	bad																
Apfelwein	bad																
Blei	mid																
Latrine	bad																
Bibliothek	bad																
Dachboden	bad																
Leopard	bad																
Bildpunkt	bad																
Seepferdchen	bad																
Karawane	bad																
Schildkröte	bad																
Stalaktit	bad																
Krustentier	bad																
Souvenir	bad																
Spirituose	bad																
Zedernholz	bad																
Unkraut	bad																
Nikotin	bad																
Sirup	bad																
Verdickung	bad																
Vinaigrette	bad																
Indio	bad																
Hämoglobin	bad																
Kleinod	bad																
Dickdarm	bad																
Vorplatz	good																
Häuserblock	bad																
Zeder	bad																
Petroleum	bad																
Zisterne	good																
Granat	bad																
Horoskop	bad																
Zwiebel	bad																
Makrele	bad																
Kirschwasser	bad																
Kakao	bad																
Süßholz	bad																
Zusammenfluß	bad																
Garnison	bad																
Schimmelpilz	bad																
Gras	bad																
Pigment	bad																
Tagebuch	bad																
Pflaume	bad																
Wanne	bad																
Feuerball	bad																
Keil	bad																
Weide	good																
Jungtier	bad																
Schwarze	bad																
Betrachter	bad																
Kristall	bad																
Agave	bad																
Koloß	bad																
Panier	bad																
Seeufer	bad																
Meer	bad																
Sümmchen	bad																
Egge	bad																
Bohnenkraut	bad																
Fahrstreifen	bad																
Säckel	bad																
Botulismus	bad																
Garnele	bad																
Eiskappe	bad																
Altar	bad																
Tank	bad																
Busen	bad																
Apotheke	bad																
Kiosk	bad																
Herzkammer	bad																
Etikett	bad																
Holunder	bad																
Düne	good																
Raumfahrzeug	bad																
Spaghetti	bad																
Regiment	bad																
Harz	bad																
Apfelsine	bad																
Haubitze	bad																
Schilfrohr	bad																
Seevogel	bad																
Nachthemd	bad																
Mundwasser	bad																
Signet	bad																
Joppe	bad																
Fontäne	good																
Rebstock	bad																
Wassermelone	bad																
Hüttenwerk	bad																
Amber	bad																
Wagenlenker	bad																
Kichererbse	bad																
Mammutbaum	bad																
Diamant	bad																
Dachfenster	bad																
Vorhof	mid																
Kessel	bad																
Eckzahn	bad																
Faksimile	bad																
Mastdarm	bad																
Steinbock	bad																
Wasserlinie	bad																
Äuglein	bad																
Bullauge	bad																
Marschland	bad																
Altarbild	mid																
Brillenglas	bad																
Torbogen	good																
Sonnendach	bad																
Mikrofilm	bad																
Kreuz	bad																
Guckloch	bad																
Festung	bad																
Altarraum	bad																
Kreide	bad																
Querschiff	bad																
Schriftzug	bad																
Velodrom	bad																
Zyste	bad																
Superman	bad																
Kornfeld	good																
Rinnstein	bad																
Saum	bad																
Kleinhirn	bad																
Stadtstaat	bad																
Schuppe	bad																
Sekret	bad																
Bahndamm	bad																
Krug	bad																
Grasland	bad																
Kavallerie	bad																
Kiesel	bad																
Britin	bad																
Onyx	bad																
Schalotte	bad																
Küste	bad																
Lorbeer	bad																
Pelikan	bad																
Krater	mid																
Faß	bad																
Aster	bad																
Schlange	bad																
Karamel	bad																
Fühler	bad																
Badehaus	bad																
Wildblume	bad																
Buschwerk	bad																
Mondkalb	bad																
Stute	bad																
Dahlie	bad																
Feuerkugel	bad																
Löwenzahn	bad																
Fleischhauer	bad																
Heckklappe	bad																
Mineralstoff	bad																
Aktenstück	bad																
Membrane	bad																
Moor	good																
Perle	bad																
Square	bad																
Zusatzstoff	bad																
Schlehe	bad																
Mauerstein	bad																
Duft	bad																
Krem	bad																
Hügelgrab	bad																
Narbe	bad																
Pilz	bad																
Galle	bad																
Drehgestell	bad																
Goetheplatz	bad																
Armenhaus	bad																
Kassenbon	bad																
Abzeichen	good																
Mauerstraße	bad																
Dickicht	bad																
Kapsel	bad																
Pulsader	bad																
Pollen	bad																
Dock	good																
Weißdorn	bad																
Raumfahrer	bad																
Bracke	bad																
Fernrohr	bad																
Insekt	bad																
Patte	bad																
Wandelhalle	bad																
Fohlen	bad																
Sonnenschein	bad																
Wandbild	bad																
Kies	good																
Diele	good																
Biotop	mid																
Achteck	bad																
Viadukt	good																
Eichel	bad																
Schnecke	good																
Borte	bad																
Knoblauch	bad																
Mädchen	bad																
Kerzenlicht	bad																
Symptom	bad																
Zirrhose	bad																
Cabrio	bad																
Hämatom	bad																
Sombrero	bad																
Sandelholz	bad																
Gramm	bad																
Melone	bad																
Banane	bad																
Aquarium	bad																
Minze	bad																
Seehafen	bad																
Geschwür	bad																
Scheidewand	bad																
Akazie	mid																
Ikone	bad																
Mongole	bad																
Karlsplatz	bad																
Graben	bad																
Lagune	good																
Flaneur	bad																
Zebra	bad																
Gallenblase	bad																
Fresko	bad																
Sofa	bad																
Pudding	bad																
Kalk	bad																
Sonde	good																
Gelände	bad																
Haut	bad																
Wasser	bad																
Weintraube	bad																
Vorspeise	bad																
Kocher	bad																
Götzenbild	bad																
Wasserkopf	bad																
Kiefer	bad																
Flanke	bad																
Querkopf	bad																
Landzunge	bad																
Brille	bad																
Tankschiff	bad																
Wiederkäuer	bad																
Sarkophag	good																
Acre	bad																
Gin	bad																
Marienstraße	bad																
Silhouette	bad																
Mausoleum	good																
Schatzkammer	good																
Buchläden	 bad																
Miesmuschel	 bad																
Fruchtzucker	 bad																
Krabbe	 bad																
Gekreuzigte	 bad																
Heroin	 bad																
Pfeffer	 bad																
Fassade	mid																
Libelle	bad																
Saft	bad																
Glatze	bad																
Vesuv	bad																
Gote	bad																
Banknote	bad																
Zypresse	bad																
Hausboot	bad																
Arterie	bad																
Hibiskus	bad																
Tragwerk	bad																
Harnleiter	bad																
Vlies	bad																
Maggi	bad																
Mähne	bad																
Vorderfront	bad																
Schneefeld	bad																
Schnauze	bad																
Seitenschiff	bad																
Phallus	bad																
Dotter	bad																
Trottoir	bad																
Bootshaus	bad																
Atom	bad																
Marienkäfer	bad																
Sauerkraut	bad																
Bridge	bad																
Staude	good																
Aprikose	bad																
Ranch	bad																
Kornblume	bad																
Flüssigkeit	bad																
Toga	bad																
Kitt	bad																
Grünzeug	bad																
Pier	bad																
Buchsbaum	bad																
Zentaur	bad																
Halde	bad																
Bungalow	bad																
Kieselstein	good																
Anatom	bad																
Schlangenbiß	bad																
Samenkorn	bad																
Brustwehr	bad																
Nest	bad																
Markstein	bad																
Alabaster	bad																
Platz	bad																
Lotos	bad																
Kalzium	bad																
Aroma	bad																
Tinktur	bad																
Schnurrbart	bad																
Medaillon	bad																
Schiebedach	bad																
Pulver	bad																
Pool	bad																
Fjord	bad																
Büschel	bad																
Stulle	bad																
Sonnenbrand	bad																
Sonnenblume	bad																
Nebengebäude	bad																
Regenrinne	good																
Schutzhütte	bad																
Sternbild	bad																
Drehkreuz	bad																
Vorzimmer	bad																
Orchidee	bad																
Eierlikör	bad																
Router	bad																
Knospe	bad																
Marienplatz	bad																
Ufer	good																
Falkensee	bad																
Dromedar	mid																
Rille	bad																
Mensa	bad																
Bergwerk	bad																
Chrysantheme	bad																
Efeu	bad																
Hotel	bad																
Gaswerk	bad																
Whisky	bad																
Rachen	bad																
Totenschädel	bad																
Fliegenpilz	bad																
Exkrement	bad																
Hautarzt	sound																
Sonnenbank	bad																
Diagramm	bad																
Schopf	bad																
Zitrone	bad																
Europaplatz	bad																
Terpentin	bad																
Grapefruit	bad																
Anwesen	good																
Viereck	bad																
Brückenkopf	bad																
Albumin	bad																
Kastanie	mid																
Umzäunung	good																
Lid	bad																
Quader	bad																
Prisma	bad																
Matterhorn	bad																
Natter	bad																
Knolle	bad																
Beiwagen	bad																
Kragen	bad																
Knotenpunkt	bad																
Hofgarten	bad																
Kehle	bad																
Regentropfen	bad																
Kirchhof	bad																
Grenadier	bad																
Wohnstatt	bad																
Sonnenhut	bad																
Azalee	bad																
Lende	bad																
Margerite	bad																
Gecko	bad																
Vordach	good																
Steilküste	bad																
Schwanz	bad																
Feldstein	bad																
Drogist	bad																
Birkenstock	bad																
Winterhude	bad																
Appartment	bad																
Flügeldecke	bad																
Schilf	bad																
Mehlwurm	bad																
Quai	bad																
Barke	good																
Theke	bad																
Wurmfortsatz	bad																
Ftp	bad																
Dicke	bad																
Nasenflügel	bad																
Dachrinne	bad																
Brei	bad																
Karree	bad																
Schlupfloch	bad																
Abbild	mid																
Ast	good																
Flagschiff	bad																
Hühnerauge	bad																
Ladenlokal	bad																
Bahnstraße	bad																
Zwischenstop	bad																
Auswuchs	bad																
Asbest	bad																
Feststoff	bad																
Kobra	bad																
Frontseite	bad																
Taverne	bad																
Zugbrücke	bad																
Farmhaus	bad																
Speckstein	bad																
Siesta	bad																
Kieselalge	bad																
Vorschiff	bad																
Brennessel	bad																
Spinnentier	bad																
Mangrove	bad																
Saat	bad																
Brandmauer	bad																
Heilbutt	bad																
Wodka	bad																
Weinberg	bad																
Hafen	bad																
Warze	bad																
Schweif	mid																
Bärtige	bad																
Quarter	bad																
Sindelfinger	bad																
Kinn	bad																
Antlitz	bad																
Pulpa	bad																
Harnblase	bad																
Limousine	bad																
Niere	bad																
Scheinwerfer	bad																
Kokain	bad																
Vestibül	bad																
Nordstadt	bad																
Gästehaus	bad																
Stockwerk	bad																
Gruft	good																
Limo	bad																
Säulengang	bad																
Eis	bad																
Honigtau	bad																
Nektar	bad																
Bauch	bad																
Brauhaus	bad																
Ringstraße	bad																
Unterkleid	bad																
Hohlraum	bad																
Yachthafen	bad																
Kardamom	bad																
Zitadelle	bad																
Jerusalemer	bad																
Kaninchen	bad																
Haube	good																
Bauchfell	bad																
Strand	bad																
Beere	bad																
Wein	bad																
Eintopf	bad																
Robe	bad																
Pixel	bad																
Likör	bad																
Areal	bad																
Waisenhaus	bad																
Hirninfarkt	bad																
Labyrinth	bad																
Brösel	bad																
Bier	bad																
Turmspitze	mid																
Turban	bad																
Mietskaserne	bad																
Erdkugel	bad																
Mango	bad																
Espe	bad																
Sauce	bad																
Apartment	bad																
Fachwerk	bad																
Körnchen	bad																
Rote	bad																
Pilger	bad																
Soße	bad																
Schlafsaal	bad																
Tröpfchen	bad																
Kubus	bad																
Goldfinger	bad																
Wandschrank	bad																
Seebrücke	bad																
Urin	bad																
Uniform	bad																
Geißel	bad																
Fleck	good																
Facelift	bad																
Grabplatte	bad																
Refraktor	bad																
Coupon	bad																
Stadtplan	bad																
Auster	bad																
Leuchtfeuer	bad																
Palast	bad																
Steinweg	mid																
Cognac	bad																
Auguststraße	bad																
Zapfstelle	bad																
Vogelbeere	bad																
Bauwerk	bad																
Lungenflügel	bad																
Schnellbahn	bad																
Kabeljau	bad																
Tonerde	bad																
Trüffel	bad																
Polyp	bad																
Ginster	bad																
Schindel	bad																
Tomate	bad																
Rennpferd	bad																
Körpergröße	bad																
Bachlauf	bad																
Zwerg	bad																
H&M	bad																
Larve	bad																
Fettback	bad																
Fischsuppe	bad																
Glanzpunkt	bad																
Straßenrand	bad																
Fluß	bad																
Küchlein	bad																
Büste	good																
Klitoris	bad																